111111111
1P00C0001
100000001
100000001
1C00C00C1
100000001
100000001
1000C00E1
111111111
