111111111
1P0000001
100000001
100000001
1000C0001
100000001
100000011
1000001E1
111111111