111111111
1P0000001
100000001
100010001
1001C1001
100010001
100000001
1000000E1
111111111