111111111
1P0000001
100000001
100000001
100000001
100000001
100000001
1000000E1
11111C111