111111111111111
1000P0000000001
1001E1000000CC1
10010100000CCC1
111111111111111