111111111
100000001
100000001
100000001
1000C0001
100000001
100000001
1000000E1
111111111