1111111
1C11111
1CPCE11
1111111