1111111
1C11111
1C0CE11
1111111